Company Name	API ID
3CNERGY LIMITED	502:CATALIST
800 SUPER HOLDINGS LIMITED	5TG:CATALIST
8TELECOM INTL HOLDINGS CO LTD	E25:SGX
AA GROUP HOLDINGS LTD.	5GZ:CATALIST
AAT CORPORATION LIMITED	TF7:SGX
ABR HOLDINGS LIMITED	533:SGX
ABTERRA LTD	L5I:SGX
ACE ACHIEVE INFOCOM LIMITED	A75:SGX
ACHIEVA LIMITED	A02:SGX
ACMA LTD.	A01:SGX
ACTION ASIA LIMITED	A59:SGX
ADDVALUE TECHNOLOGIES LTD	A31:SGX
ADV INTEGRATED MFG CORP LTD	A54:SGX
ADVANCE SCT LIMITED	5FH:SGX
ADVANCED HOLDINGS LTD.	5IA:SGX
ADVANCED SYSTEMS AUTOMATION	5TY:CATALIST
ADVENTUS HOLDINGS LIMITED	5EF:CATALIST
AEI CORPORATION LTD	A18:SGX
AEM HOLDINGS LTD	A10:SGX
AIMS AMP CAP INDUSTRIAL REIT	O5RU:SGX
AIMS PROPERTY SECURITIES FUND	A0P:SGX
ALBEDO LIMITED	5IB:CATALIST
ALLIED TECHNOLOGIES LIMITED	A13:SGX
AMARA HOLDINGS LTD	A34:SGX
AMPLEFIELD LIMITED	C60:SGX
AMTEK ENGINEERING LTD	M1P:SGX
ANCHUN INTERNATIONAL HLDGS LTD	MF5:SGX
ANNAIK LIMITED	A52:SGX
ANNICA HOLDINGS LIMITED	5AL:CATALIST
ANWELL TECHNOLOGIES LIMITED	G5X:SGX
AP OIL INTERNATIONAL LIMITED	5AU:SGX
ARA ASSET MANAGEMENT LIMITED	D1R:SGX
ARMARDA GROUP LIMITED	5EK:CATALIST
ARTIVISION TECHNOLOGIES LTD.	5NK:CATALIST
ASCENDAS HOSPITALITY TRUST	Q1P:SGX
ASCENDAS INDIA TRUST	CY6U:SGX
ASCENDAS REAL ESTATE INV TRUST	A17U:SGX
ASCOTT RESIDENCE TRUST	A68U:SGX
ASIA ENTERPRISES HOLDING LTD	A55:SGX
ASIA FASHION HOLDINGS LIMITED	GH3:SGX
ASIA POWER CORP LTD	A03:SGX
ASIAMEDIC LIMITED	505:CATALIST
ASIAN MICRO HOLDINGS LTD	585:CATALIST
ASIAN PAY TELEVISION TRUST	S7OU:SGX
ASIA-PACIFIC STRATEGIC INV LTD	5RA:CATALIST
ASIAPHOS LIMITED	5WV:CATALIST
ASIASONS CAPITAL LIMITED	5ET:SGX
ASIATIC GROUP (HOLDINGS) LTD	5CR:CATALIST
ASIATRAVEL.COM HOLDINGS LTD	5AM:CATALIST
ASJ HOLDINGS LTD	538:SGX
ASL MARINE HOLDINGS LTD	A04:SGX
A-SONIC AEROSPACE LIMITED	A53:SGX
ASPIAL CORPORATION LIMITED	A30:SGX
ASTI HOLDINGS LIMITED	575:SGX
ATLANTIC NAVIGATION HLDG(S)LTD	5UL:CATALIST
AURIC PACIFIC GROUP LIMITED	A23:SGX
AUSGROUP LIMITED	5GJ:SGX
AVIC INTL MARITIME HLDGLIMITED	O2I:SGX
AVI-TECH ELECTRONICS LIMITED	CT1:SGX
AZEUS SYSTEMS HOLDINGS LTD.	A69:SGX
AZTECH GROUP LTD.	560:SGX
BAKER TECHNOLOGY LIMITED	568:SGX
BAN LEONG TECHNOLOGIES LIMITED	B26:SGX
BANYAN TREE HOLDINGS LIMITED	B58:SGX
BBR HOLDINGS (S) LTD	KJ5:SGX
BENG KUANG MARINE LIMITED	5MC:SGX
BEST WORLD INTERNATIONAL LTD	5ER:SGX
BH GLOBAL CORPORATION LIMITED	B32:SGX
"BIOSENSORS INT'L GROUP, LTD."	B20:SGX
BLUMONT GROUP LTD.	A33:SGX
BOARDROOM LIMITED	B10:SGX
BONVESTS HOLDINGS LTD	B28:SGX
BOUSTEAD SINGAPORE LIMITED	F9D:SGX
BRC ASIA LIMITED	B03:SGX
BREADTALK GROUP LIMITED	5DA:SGX
BRITISH & MALAYAN TRUSTEES LTD	B08:SGX
BROADWAY INDUSTRIAL GROUP LTD	B69:SGX
BROOKE ASIA LIMITED	5OY:CATALIST
BUKIT SEMBAWANG ESTATES LTD	B61:SGX
BUMITAMA AGRI LTD.	P8Z:SGX
BUND CENTER INVESTMENT LTD	MQ4:SGX
C&G ENV PROTECT HLDGS LTD	D79:SGX
CACHE LOGISTICS TRUST	K2LU:SGX
CACOLA FURNITURE INTL LIMITED	D2U:SGX
CAMBRIDGE INDUSTRIAL TRUST	J91U:SGX
CAPITACOMMERCIAL TRUST	C61U:SGX
CAPITALAND LIMITED	C31:SGX
CAPITAMALL TRUST	C38U:SGX
CAPITAMALLS ASIA LIMITED	JS8:SGX
CAPITARETAIL CHINA TRUST	AU8U:SGX
CAPTII LIMITED	U18:SGX
CASA HOLDINGS LIMITED	C04:SGX
CCFH LTD.	5RF:CATALIST
CCM GROUP LIMITED	5QZ:CATALIST
CDL HOSPITALITY TRUSTS	J85:SGX
CDW HOLDING LIMITED	D38:SGX
CEDAR STRATEGIC HOLDINGS LTD	530:CATALIST
CEFC INTERNATIONAL LIMITED	Y35:SGX
CEI CONTRACT MANUFACTURING LTD	C11:SGX
CELESTIAL NUTRIFOODS LIMITED	C56:SGX
CENTURION CORPORATION LIMITED	OU8:SGX
CFM HOLDINGS LIMITED	5EB:CATALIST
CH OFFSHORE LTD	C13:SGX
CHALLENGER TECHNOLOGIES LTD	573:SGX
CHANGJIANG FERTILIZER HLGS LTD	JA9:SGX
CHANGTIAN PLASTIC & CHEM LTD	D2V:SGX
CHARISMA ENERGY SERVICES LTD	5QT:CATALIST
CHASEN HOLDINGS LIMITED	5NV:SGX
CHASWOOD RESOURCES HLDGS LTD.	5TW:CATALIST
CHEMICAL INDUSTRIES (F.E.) LTD	C05:SGX
CHEMOIL ENERGY LIMITED	AV5:SGX
CHEUNG WOH TECHNOLOGIES LTD	C50:SGX
CHEW'S GROUP LIMITED	5SY:CATALIST
CHINA AUTO ELECTRONICS GRP LTD	T42:SGX
CHINA AVIATION OIL(S) CORP LTD	G92:SGX
CHINA BEARING (SINGAPORE) LTD.	AD7:SGX
CHINA DAIRY GROUP LTD	T16:SGX
CHINA ENERGY LIMITED	A0G:SGX
CHINA ENVIRONMENT LTD.	5OU:SGX
CHINA ENVIRONMENTAL RES GP LTD	RS1:SGX
CHINA ESSENCE GROUP LTD.	G54:SGX
CHINA FIBRETECH LTD.	F6D:SGX
CHINA FISHERY GROUP LIMITED	B0Z:SGX
CHINA FLEXIBLE PACK HLDG LTD	C59:SGX
CHINA GAOXIAN FIBREFAB HLDGLTD	I4U:SGX
CHINA GREAT LAND HOLDINGS LTD.	D50:SGX
CHINA HAIDA LTD.	C92:SGX
CHINA HONGCHENG HOLDINGS LTD	C0Z:SGX
CHINA HONGXING SPORTS LIMITED	BR9:SGX
CHINA INTERNATIONAL HLDGS LTD	C37:SGX
CHINA JISHAN HOLDINGS LIMITED	J18:SGX
CHINA KANGDA FOOD COMPANY LTD	P74:SGX
CHINA KUNDA TECH HOLDINGS LTD	GU5:SGX
CHINA MERCHANTS HLDGS(PACIFIC)	C22:SGX
CHINA MERCHANTS PROP DEVTCOLTD	C03:SGX
CHINA MILK PRODUCTS GROUP LTD	G86:SGX
CHINA MINING INTERNATIONAL LTD	Y34:SGX
CHINA MINZHONG FOOD CORP LTD	K2N:SGX
CHINA NEW TOWN DEVT CO LIMITED	D4N:SGX
CHINA OILFIELD TEC SVCS GRPLTD	DT2:SGX
CHINA PAPER HOLDINGS LIMITED	C71:SGX
CHINA POWERPLUS LIMITED	Z02:SGX
CHINA PRINT POWER GROUP LTD	B3C:SGX
"CHINA SKY CHEM FIBRE CO., LTD."	E90:SGX
CHINA SPORTS INTL LIMITED	FQ8:SGX
CHINA SUN BIOCHEM TECH GP CO.	C86:SGX
CHINA SUNSINE CHEM HLDGS LTD.	CH8:SGX
CHINA TAISAN TECH GRP HLDGSLTD	F2X:SGX
CHINA XLX FERTILISER LTD.	B9R:SGX
CHINA YONGSHENG LIMITED	5KK:CATALIST
CHINA YUANBANG PROP HLDGS LTD	B2X:SGX
CHINASING INVESTMENT HLDG LTD	O2R:SGX
CHINAVISION MEDIA GRP LIMITED	S91:SGX
CHINESE GLOBAL INVESTORS GRP	5CJ:CATALIST
CHIP ENG SENG CORPORATION LTD	C29:SGX
CHOSEN HOLDINGS LIMITED	C10:SGX
CHUAN HUP HOLDINGS LIMITED	C33:SGX
CITY DEVELOPMENTS LIMITED	C09:SGX
CITYNEON HOLDINGS LIMITED	5HJ:SGX
CITYSPRING INFRASTRUCT TRUST	A7RU:SGX
CIVMEC LIMITED	P9D:SGX
CNA GROUP LTD.	5GC:SGX
CNMC GOLDMINE HOLDINGS LIMITED	5TP:CATALIST
COGENT HOLDINGS LIMITED	KJ9:SGX
COLEX HOLDINGS LIMITED	567:CATALIST
COMBINE WILL INTL HLDGS LTD	N0Z:SGX
COMFORTDELGRO CORPORATION LTD	C52:SGX
COMMUNICATION DESIGN INTL LTD	5HT:CATALIST
COMPACT METAL INDUSTRIES LTD	T4E:SGX
CORDLIFE GROUP LIMITED	P8A:SGX
CORTINA HOLDINGS LIMITED	C41:SGX
COSCO CORPORATION (S) LTD	F83:SGX
COSMOSTEEL HOLDINGS LIMITED	B9S:SGX
COURAGE MARINE GROUP LIMITED	E91:SGX
COURTS ASIA LIMITED	RE2:SGX
CPH LTD	539:CATALIST
CRAFT PRINT INTERNATIONAL LTD	541:CATALIST
CREATIVE TECHNOLOGY LTD	C76:SGX
CROESUS RETAIL TRUST	S6NU:SGX
CSC HOLDINGS LTD	C06:SGX
CSE GLOBAL LTD	544:SGX
CWT LIMITED	C14:SGX
DAIRY FARM INT'L HOLDINGS LTD	D01:SGX
DAPAI INTL HLDG CO. LTD.	FP1:SGX
DARCO WATER TECHNOLOGIES LTD	5CB:SGX
DATAPULSE TECHNOLOGY LIMITED	D04:SGX
DBS GROUP HOLDINGS LTD	D05:SGX
DEBAO PROPERTY DEVELOPMENT LTD	K2M:SGX
DECLOUT LIMITED	5UZ:CATALIST
DEL MONTE PACIFIC LIMITED	D03:SGX
DELONG HOLDINGS LIMITED	B1N:SGX
DESIGN STUDIO GROUP LTD.	D11:SGX
DIGILAND INTERNATIONAL LTD	G77:SGX
DMX TECHNOLOGIES GROUP LTD	5CH:SGX
DRAGON GROUP INTL LIMITED	MT1:SGX
DUKANG DISTILLERS HLDGS LTD	GJ8:SGX
DUTECH HOLDINGS LIMITED	CZ4:SGX
DUTY FREE INTERNATIONALLIMITED	5SO:CATALIST
DYNA-MAC HOLDINGS LTD.	NO4:SGX
DYNAMIC COLOURS LIMITED	D6U:SGX
E2-CAPITAL HOLDINGS LIMITED	5OF:CATALIST
EASTERN HOLDINGS LTD	5KU:SGX
EASTGATE TECHNOLOGY LTD	N0L:SGX
ECOWISE HOLDINGS LIMITED	5CT:SGX
ECS HOLDINGS LIMITED	E18:SGX
ELEC & ELTEK INT CO LTD	E16:SGX
ELEKTROMOTIVE GROUP LIMITED	5VU:CATALIST
ELLIPSIZ LTD	E13:SGX
EMS ENERGY LIMITED	5DE:CATALIST
ENGRO CORPORATION LIMITED	S44:SGX
ENVIRO-HUB HOLDINGS LTD	L23:SGX
EPICENTRE HOLDINGS LIMITED	5MQ:CATALIST
EQUATION CORP LIMITED	532:CATALIST
ERATAT LIFESTYLE LIMITED	FO8:SGX
ES GROUP (HOLDINGS) LIMITED	5RC:CATALIST
ETIKA INTERNATIONAL HLDGS LTD	5FR:SGX
EU YAN SANG INTERNATIONAL LTD	E02:SGX
EUCON HOLDING LIMITED	E27:SGX
EUNETWORKS GROUP LIMITED	5VT:CATALIST
EUROPTRONIC GROUP LTD	E23:SGX
EUROSPORTS GLOBAL LIMITED	5G1:CATALIST
EXCELPOINT TECHNOLOGY LTD	E17:SGX
EZION HOLDINGS LIMITED	5ME:SGX
EZRA HOLDINGS LIMITED	5DN:SGX
F J BENJAMIN HOLDINGS LTD	F10:SGX
FABCHEM CHINA LIMITED	I54:SGX
FALCON ENERGY GROUP LIMITED	5FL:SGX
FAR EAST GROUP LIMITED	5TJ:CATALIST
FAR EAST HOSPITALITY TRUST	Q5T:SGX
FAR EAST ORCHARD LIMITED	O10:SGX
FEDERAL INT(2000) LTD	F20:SGX
FIBRECHEM TECHNOLOGIES LIMITED	F12:SGX
FIGTREE HOLDINGS LIMITED	5F4:CATALIST
FIRST REAL ESTATE INV TRUST	AW9U:SGX
FIRST RESOURCES LIMITED	EB5:SGX
FIRST SHIP LEASE TRUST	D8DU:SGX
FISCHER TECH LTD	F22:SGX
FOOD EMPIRE HOLDINGS LIMITED	F03:SGX
FORELAND FABRICTECH HLDS LTD	B0I:SGX
FORTERRA TRUST	LG2U:SGX
FORTUNE REAL ESTATE INV TRUST	F25U:SGX
FRAGRANCE GROUP LIMITED	F31:SGX
"FRASER AND NEAVE, LIMITED"	F99:SGX
FRASERS CENTREPOINT LIMITED	TQ5:SGX
FRASERS CENTREPOINT TRUST	J69U:SGX
FRASERS COMMERCIAL TRUST	ND8U:SGX
FRENCKEN GROUP LIMITED	E28:SGX
FU YU CORPORATION LTD	F13:SGX
FUJI OFFSET PLATES MFG LTD	508:CATALIST
FUJIAN ZHENYUN PLAS IND CO LTD	5KT:CATALIST
FULL APEX (HOLDINGS) LIMITED	F18:SGX
FUNG CHOI MEDIA GROUP LIMITED	F11:SGX
FUXING CHINA GROUP LIMITED	DC9:SGX
G. K. GOH HOLDINGS LIMITED	G41:SGX
GALLANT VENTURE LTD.	5IG:SGX
GAYLIN HOLDINGS LIMITED	RF7:SGX
GDS GLOBAL LIMITED	5VP:CATALIST
GEMS TV HOLDINGS LIMITED	AM3:SGX
GENTING HONG KONG LIMITED	S21:SGX
GENTING SINGAPORE PLC	G13:SGX
GEO ENERGY RESOURCES LIMITED	RE4:SGX
GIKEN SAKATA (S) LIMITED	542:CATALIST
GKE CORPORATION LIMITED	595:CATALIST
GLOBAL INVACOM GROUP LIMITED	QS9:SGX
GLOBAL INVESTMENTS LIMITED	B73:SGX
GLOBAL LOGISTIC PROP LIMITED	MC0:SGX
GLOBAL PALM RESOURCES HLGS LTD	K6J:SGX
GLOBAL PREMIUM HOTELS LIMITED	P9J:SGX
GLOBAL TECH (HLDGS) LIMITED	G11:SGX
GLOBAL TESTING CORPORATION LTD	G31:SGX
GLOBAL YELLOW PAGES LIMITED	Y07:SGX
GMG GLOBAL LTD	5IM:SGX
GOLDEN AGRI-RESOURCES LTD	E5H:SGX
GOLDEN OCEAN GROUP LIMITED	KU3:SGX
GOODLAND GROUP LIMITED	5PC:SGX
GOODPACK LIMITED	G05:SGX
GP BATTERIES INT LTD	G08:SGX
GP INDUSTRIES LIMITED	G20:SGX
GRAND BANKS YACHTS LIMITED	G50:SGX
GREAT EASTERN HLDGS LTD	G07:SGX
GREAT GROUP HOLDINGS LIMITED	I5H:SGX
GRP LTD	G18:SGX
GSH CORPORATION LIMITED	J16:SGX
GUOCOLAND LIMITED	F17:SGX
GUOCOLEISURE LIMITED	B16:SGX
HAFARY HOLDINGS LIMITED	5VS:SGX
HAI LECK HOLDINGS LIMITED	GG7:SGX
HALCYON AGRI CORPORATION LTD	5VJ:CATALIST
HANKORE ENVIRONMENT TEC GRPLTD	B22:SGX
HANWELL HOLDINGS LIMITED	DM0:SGX
HAW PAR CORP LTD	H02:SGX
HEALTH MANAGEMENT INTL LTD	588:SGX
HEALTHWAY MEDICAL CORP LTD	5NG:CATALIST
HEATEC JIETONG HOLDINGS LTD.	5OR:CATALIST
HEETON HOLDINGS LIMITED	5DP:SGX
HENGXIN TECHNOLOGY LTD.	I85:SGX
HENGYANG PETROCHEM LOG LIMITED	5PD:CATALIST
HG METAL MANUFACTURING LTD	526:SGX
HIAP HOE LIMITED	5JK:SGX
HIAP SENG ENGINEERING LTD	510:SGX
HIAP TONG CORPORATION LTD.	5PO:CATALIST
HI-P INTERNATIONAL LIMITED	H17:SGX
HISAKA HOLDINGS LTD.	FV2:SGX
HL GLOBAL ENTERPRISES LIMITED	L18:SGX
HLH GROUP LIMITED	H27:SGX
HO BEE LAND LIMITED	H13:SGX
HOCK LIAN SENG HOLDINGS LTD	J2T:SGX
HOE LEONG CORPORATION LTD.	H20:SGX
HONG FOK CORPORATION LTD	H30:SGX
HONG LEONG ASIA LTD.	H22:SGX
HONG LEONG FINANCE LIMITED	S41:SGX
HONGKONG LAND HOLDINGS LIMITED	H78:SGX
HOR KEW CORPORATION LIMITED	H06:SGX
HOSEN GROUP LTD	5EV:CATALIST
HOTEL GRAND CENTRAL LTD	H18:SGX
HOTEL PROPERTIES LTD	H15:SGX
HOTEL ROYAL LTD	H12:SGX
HOTUNG INVESTMENT HLDGS LTD	NT1:SGX
HTL INT'L HOLDINGS LIMITED	H64:SGX
HU AN CABLE HOLDINGS LTD.	KI3:SGX
HUAN HSIN HOLDINGS LTD	H16:SGX
HUPSTEEL LTD	H73:SGX
HUTCHISON PORT HOLDINGS TRUST	NS8U:SGX
HWA HONG CORPORATION LIMITED	H19:SGX
HYFLUX LTD	600:SGX
ICP LTD	536:CATALIST
ICP LTD	5I4:CATALIST
IEV HOLDINGS LIMITED	5TN:CATALIST
IFS CAPITAL LIMITED	I49:SGX
IHH HEALTHCARE BERHAD	Q0F:SGX
INCH KENNETH KAJANG RUBBER PLC	I4R:SGX
INDIABULLS PROPERTIES INVTRUST	F3EU:SGX
INDOFOOD AGRI RESOURCES LTD.	5JS:SGX
INFINIO GROUP LIMITED	5G4:CATALIST
INFORMATICS EDUCATION LTD.	I03:SGX
INNOPAC HOLDINGS LIMITED	I26:SGX
INNOTEK LIMITED	M14:SGX
INNOVALUES LIMITED	591:SGX
INTERNATIONAL PRESS SOFTCOM	571:CATALIST
INTERRA RESOURCES LIMITED	5GI:SGX
INTL HEALTHWAY CORP LIMITED	5WA:CATALIST
INTRACO LIMITED	I06:SGX
IPC CORPORATION LIMITED	I12:SGX
IPCO INT'L LIMITED	I11:SGX
ISDN HOLDINGS LIMITED	I07:SGX
ISETAN (SINGAPORE) LTD	I15:SGX
ISOTEAM LTD.	5WF:CATALIST
ISR CAPITAL LIMITED	5EC:SGX
ITE ELECTRIC CO LTD	581:CATALIST
JACKS INTERNATIONAL LIMITED	J11:SGX
JACKSPEED CORPORATION LIMITED	J17:SGX
JADASON ENTERPRISES LTD	J03:SGX
JAPAN FOODS HOLDING LTD.	5OI:CATALIST
JARDINE CYCLE & CARRIAGE LTD	C07:SGX
JARDINE MATHESON HLDGS LTD	J36:SGX
JARDINE STRATEGIC HLDGS LTD	J37:SGX
JASON HOLDINGS LIMITED	5I3:CATALIST
JASON MARINE GROUP LIMITED	5PF:CATALIST
JASPER INVESTMENTS LIMITED	FQ7:SGX
JAYA HOLDINGS LTD	J10:SGX
JB FOODS LIMITED	Q0W:SGX
JEP HOLDINGS LTD.	5FA:CATALIST
JES INTERNATIONAL HOLDINGS LTD	EG0:SGX
JIUTIAN CHEMICAL GROUP LIMITED	C8R:SGX
JK TECH HOLDINGS LIMITED	5TS:CATALIST
JOYAS INTERNATIONAL HLDGS LTD	E9L:SGX
JUBILEE INDUSTRIES HLDGS LTD.	5OS:CATALIST
JUNMA TYRE CORD COMPANY LTD	5TF:CATALIST
K1 VENTURES LIMITED	K01:SGX
KARIN TECHNOLOGY HLDGS LIMITED	K29:SGX
KENCANA AGRI LIMITED	F9M:SGX
KEONG HONG HOLDINGS LIMITED	5TT:CATALIST
KEPPEL CORPORATION LIMITED	BN4:SGX
KEPPEL INFRASTRUCTURE TRUST	LH4U:SGX
KEPPEL LAND LIMITED	K17:SGX
KEPPEL REIT	K71U:SGX
KEPPEL TELE & TRAN	K11:SGX
KHONG GUAN FLOUR MILLING LTD	K03:SGX
KIAN HO BEARINGS LTD	K22:SGX
KIMHENG OFFSHORE&MARINE HLDLTD	5G2:CATALIST
KING WAN CORPORATION LIMITED	554:SGX
KINGBOARD COPPER FOIL HDGS LTD	K14:SGX
KINGSMEN CREATIVES LTD	5MZ:SGX
KITCHEN CULTURE HOLDINGS LTD.	5TI:CATALIST
KLW HOLDINGS LTD	504:CATALIST
KODA LTD	5BK:SGX
KOH BROTHERS ECO ENGG LIMITED	5HV:CATALIST
KOH BROTHERS GROUP LIMITED	K75:SGX
KOON HOLDINGS LIMITED	5DL:SGX
KOP LIMITED	5I1:CATALIST
KORI HOLDINGS LIMITED	5VC:CATALIST
KOYO INTERNATIONAL LIMITED	5OC:CATALIST
KRISENERGY LTD.	SK3:SGX
KS ENERGY LIMITED	578:SGX
KSH HOLDINGS LIMITED	ER0:SGX
KTL GLOBAL LIMITED	EB7:SGX
LAFE CORPORATION LIMITED	L05:SGX
LANKOM ELECTRONICS LIMITED	L22:SGX
LANTROVISION (S) LTD	Q7W:SGX
LASSETERS INTL HOLDINGS LTD	5EL:CATALIST
LCD GLOBAL INVESTMENTS LTD.	L38:SGX
LEADER ENVIRONMENTAL TECH LTD	LS9:SGX
LEE KIM TAH HLDGS LIMITED	L25:SGX
LEE METAL GROUP LTD	593:SGX
LERENO BIO-CHEM LTD.	587:CATALIST
LEY CHOON GROUP HLDG LIMITED	Q0X:SGX
LH GROUP LIMITED	C4P:SGX
LHT HOLDINGS LIMITED	L10:SGX
LI HENG CHEM FIBRE TECH LTD	E9A:SGX
LIAN BENG GROUP LTD	L03:SGX
LIBRA GROUP LIMITED	5TR:CATALIST
LIFEBRANDZ LTD.	L20:SGX
LINAIR TECHNOLOGIES LIMITED	5FW:CATALIST
LINC ENERGY LTD	TI6:SGX
LINDETEVES-JACOBERG LTD	L15:SGX
LION ASIAPAC LTD	L08:SGX
LION TECK CHIANG LTD	L17:SGX
LIONGOLD CORP LTD	A78:SGX
LIPPO MALLS INDO RETAIL TRUST	D5IU:SGX
LIZHONG WHEEL GROUP LTD.	E94:SGX
LOGISTICS HOLDINGS LIMITED	5VI:CATALIST
LONGCHEER HOLDINGS LIMITED	L28:SGX
LONZA GROUP LTD	O6Z:SGX
LORENZO INTERNATIONAL LIMITED	5IE:SGX
LOTTVISION LIMITED	M22:SGX
LOW KENG HUAT (SINGAPORE) LTD	F1E:SGX
LOYZ ENERGY LIMITED	594:CATALIST
LUM CHANG HOLDINGS LIMITED	L19:SGX
LUNG KEE (BERMUDA) HLDGS LTD	L09:SGX
LUXKING GROUP HOLDINGS LIMITED	L34:SGX
LUZHOU BIO-CHEM TECHNOLOGY LTD	L46:SGX
M DEVELOPMENT LTD.	N14:SGX
M1 LIMITED	B2F:SGX
MACQUARIE INT'L INFRA FUND LTD	M41:SGX
MAGNUS ENERGY GROUP LTD.	576:CATALIST
MALAYSIA SMELTING CORP BHD 100	NC9:SGX
MANDARIN ORIENTAL INTL LTD	M04:SGX
MANHATTAN RESOURCES LIMITED	L02:SGX
MANN SENG METAL INTL LIMITED	5QR:CATALIST
MAPLETREE COMMERCIAL TRUST	N2IU:SGX
MAPLETREE GREATER CHINACOMM TR	RW0U:SGX
MAPLETREE INDUSTRIAL TRUST	ME8U:SGX
MAPLETREE LOGISTICS TRUST	M44U:SGX
MARCO POLO MARINE LTD.	5LY:SGX
MARUWA CO. LTD	M12:SGX
MARY CHIA HOLDINGS LIMITED	5OX:CATALIST
MATEX INTERNATIONAL LIMITED	M15:SGX
MAXI-CASH FIN SVCS CORP LTD	5UF:CATALIST
MDR LIMITED	A27:SGX
MEDTECS INTERNATIONAL CORP LTD	546:CATALIST
MEGACHEM LIMITED	5DS:CATALIST
MEGHMANI ORGANICS LIMITED	M30:SGX
MEMSTAR TECHNOLOGY LTD.	5MS:SGX
MEMTECH INTERNATIONAL LTD	M26:SGX
MENCAST HOLDINGS LTD.	5NF:SGX
MERCATOR LINES (SINGAPORE) LTD	EE6:SGX
MERMAID MARITIME PUBLIC CO LTD	DU4:SGX
METAL COMPONENT ENGG LTD	5DX:CATALIST
METECH INTERNATIONAL LIMITED	QG1:SGX
METRO HOLDINGS LIMITED	M01:SGX
MEWAH INTERNATIONAL INC.	MV4:SGX
MFG INTEGRATION TECHNOLOGY LTD	M11:SGX
MFS TECHNOLOGY LTD	5BM:SGX
MICRO-MECHANICS (HOLDINGS) LTD	5DD:SGX
MIDAS HLDGS LIMITED	5EN:SGX
MIRACH ENERGY LIMITED	C68:SGX
MIYOSHI PRECISION LIMITED	M03:SGX
MONEYMAX FINANCIAL SERVICESLTD	5WJ:CATALIST
MOYA HOLDINGS ASIA LIMITED	5WE:CATALIST
MTQ CORPORATION LIMITED	M05:SGX
MULTI-CHEM LIMITED	M06:SGX
MUN SIONG ENGINEERING LIMITED	MF6:SGX
MURATA MFG CO. LTD 100	M20:SGX
MYP LTD.	F86:SGX
NAM CHEONG LIMITED	N4E:SGX
NAM LEE PRESSED METAL INDS LTD	G0I:SGX
NATURAL COOL HOLDINGS LIMITED	5IF:CATALIST
NEO GROUP LIMITED	5UJ:CATALIST
NEPTUNE ORIENT LINES LIMITED	N03:SGX
NERATELECOMMUNICATIONS LTD	N01:SGX
NET PACIFIC FIN HLDGS LTD	5QY:CATALIST
NEW TOYO INT HLDGS LTD	N08:SGX
NEW WAVE HOLDINGS LTD.	5FX:CATALIST
NEXT-GEN SATELLITE COMM LTD	B07:SGX
NH CERAMICS LTD	5AC:CATALIST
NICO STEEL HOLDINGS LIMITED	5GF:SGX
NIPPECRAFT LIMITED	N32:SGX
NOBEL DESIGN HOLDINGS LTD	547:SGX
NOBLE GROUP LIMITED	N21:SGX
NOEL GIFTS INTERNATIONAL LTD	543:SGX
"NOMURA HOLDINGS, INC"	N33:SGX
NORDIC GROUP LIMITED	MR7:SGX
NOVO GROUP LTD.	MR8:SGX
NSL LTD.	N02:SGX
NTEGRATOR INTERNATIONAL LTD	5HC:CATALIST
OCEAN SKY INTERNATIONAL LTD	O05:SGX
OCEANUS GROUP LIMITED	579:SGX
OEL (HOLDINGS) LIMITED	584:CATALIST
OKH GLOBAL LTD.	S3N:SGX
OKP HOLDINGS LIMITED	5CF:SGX
OLAM INTERNATIONAL LIMITED	O32:SGX
OLD CHANG KEE LTD.	5ML:CATALIST
ONIONTECH LIMITED	5HG:CATALIST
ORIENTAL GROUP LTD.	5FI:CATALIST
OSIM INTERNATIONAL LTD	O23:SGX
OSSIA INTERNATIONAL LTD	O08:SGX
OTTO MARINE LIMITED	G4F:SGX
OUE COMMERCIAL REIT	TS0U:SGX
OUE HOSPITALITY TRUST	SK7:SGX
OUE LIMITED	LJ3:SGX
OUHUA ENERGY HOLDINGS LIMITED	AJ2:SGX
OVERSEA-CHINESE BANKING CORP	O39:SGX
OVERSEAS EDUCATION LIMITED	RQ1:SGX
OXLEY HOLDINGS LIMITED	5UX:SGX
P99 HOLDINGS LIMITED	5UV:CATALIST
PACC OFFSHORE SVCS HLDG LTD.	U6C:SGX
PACIFIC ANDES RESOURCES DEVLTD	P11:SGX
PACIFIC CENTURY REGIONAL DEVTS	P15:SGX
PACIFIC HEALTHCARE HLDGS LTD	P47:SGX
PACIFIC RADIANCE LTD.	T8V:SGX
PAN ASIAN HOLDINGS LIMITED	5EW:CATALIST
PAN HONG PROPERTY GROUP LTD	P36:SGX
"PAN OCEAN CO., LTD."	TO9:SGX
PAN-UNITED CORPORATION LTD	P52:SGX
PARKSON RETAIL ASIA LIMITED	O9E:SGX
PARKWAYLIFE REIT	C2PU:SGX
PAVILLON HOLDINGS LTD.	596:SGX
PCI LTD	P19:SGX
PEC LTD.	IX2:SGX
PENGUIN INTERNATIONAL LIMITED	P13:SGX
PERENNIAL CHINA RETAIL TRUST	N9LU:SGX
PETRA FOODS LIMITED	P34:SGX
PHARMESIS INTERNATIONAL LTD.	P31:SGX
PLASTOFORM HOLDINGS LIMITED	P82:SGX
PLATO CAPITAL LIMITED	5PI:CATALIST
PNE INDUSTRIES LTD	P07:SGX
PNE MICRON HOLDINGS LTD	5BS:CATALIST
POH TIONG CHOON LOGISTICS LTD	P01:SGX
POLARIS LTD.	5BI:CATALIST
POLLUX PROPERTIES LTD.	5AE:CATALIST
POPULAR HOLDINGS LIMITED	P29:SGX
POWERMATIC DATA SYSTEMS LTD	P12:SGX
PROGEN HOLDINGS LTD	583:CATALIST
PRUDENTIAL PLC	K6S:SGX
PS GROUP HOLDINGS LTD.	5WD:CATALIST
PSL HOLDINGS LTD	L6T:SGX
PT BERLIAN LAJU TANKER TBK	B66:SGX
PTERIS GLOBAL LIMITED	J74:SGX
Q & M DENTAL GROUP (S) LIMITED	QC7:SGX
QAF LTD	Q01:SGX
QIAN HU CORPORATION LIMITED	552:SGX
QINGMEI GROUP HOLDINGS LIMITED	KT9:SGX
QT VASCULAR LTD.	5I0:CATALIST
R H ENERGY LTD.	CL7:SGX
RAFFLES EDUCATION CORP LTD	NR7:SGX
RAFFLES MEDICAL GROUP LTD	R01:SGX
RAMBA ENERGY LIMITED	R14:SGX
RELIGARE HEALTH TRUST	RF1U:SGX
RENEWABLE ENERGY ASIA GRP LTD	5DW:CATALIST
REX INTERNATIONAL HOLDING LTD	5WH:CATALIST
RH PETROGAS LIMITED	T13:SGX
RICKMERS MARITIME	B1ZU:SGX
RIVERSTONE HOLDINGS LIMITED	AP4:SGX
ROTARY ENGINEERING LIMITED	R07:SGX
ROWSLEY LTD.	A50:SGX
ROXY-PACIFIC HOLDINGS LIMITED	E8Z:SGX
RYOBI KISO HOLDINGS LTD.	J8O:SGX
S I2I LIMITED	M09:SGX
SABANA SHARI'AH COMPLIANT REIT	M1GU:SGX
SAIZEN REAL ESTATE INV TRUST	T8JU:SGX
SAKAE HOLDINGS LTD.	5DO:SGX
SAMKO TIMBER LIMITED	E6R:SGX
SAMUDERA SHIPPING LINE LTD	S56:SGX
SAN TEH LIMITED	S46:SGX
SANTAK HOLDINGS LIMITED	580:CATALIST
SAPPHIRE CORPORATION LIMITED	NF1:SGX
SARINE TECHNOLOGIES LTD	U77:SGX
SATS LTD.	S58:SGX
SBI OFFSHORE LIMITED	5PL:CATALIST
SBS TRANSIT LTD	S61:SGX
SCINTRONIX CORPORATION LTD.	T20:SGX
SECOND CHANCE PROPERTIES LTD	528:SGX
SEE HUP SENG LIMITED	566:SGX
SELECT GROUP LIMITED	5FQ:CATALIST
SEMBCORP INDUSTRIES LTD	U96:SGX
SEMBCORP MARINE LTD	S51:SGX
SERIAL SYSTEM LTD	S69:SGX
SEROJA INVESTMENTS LIMITED	IW5:SGX
SHANGHAI TURBO ENTERPRISES LTD	X27:SGX
SHANGRI-LA ASIA LIMITED	S07:SGX
SHC CAPITAL ASIA LIMITED	5UE:CATALIST
SHENG SIONG GROUP LTD	OV8:SGX
SIA ENGINEERING CO LTD	S59:SGX
SIIC ENVIRONMENT HOLDINGS LTD.	5GB:SGX
SILVERLAKE AXIS LTD	5CP:SGX
SIM LIAN GROUP LIMITED	S05:SGX
SIN GHEE HUAT CORPORATION LTD.	B7K:SGX
SIN HENG HEAVY MACHINERY LTD	KF4:SGX
SINARMAS LAND LIMITED	A26:SGX
SINCAP GROUP LIMITED	5UN:CATALIST
SING HOLDINGS LIMITED	5IC:SGX
SING INVESTMENTS & FINANCE LTD	S35:SGX
SINGAPORE AIRLINES LTD	C6L:SGX
SINGAPORE EXCHANGE LIMITED	S68:SGX
SINGAPORE INDEX FUND	S45U:SGX
SINGAPORE KITCHEN EQUIPMENTLTD	5WG:CATALIST
SINGAPORE LAND LIMITED	S30:SGX
SINGAPORE MEDICAL GROUP LTD	5OT:CATALIST
SINGAPORE POST LIMITED	S08:SGX
SINGAPORE PRESS HLDGS LTD	T39:SGX
SINGAPORE REINSURANCE COR LTD	S49:SGX
SINGAPORE SHIPPING CORP LTD	S19:SGX
SINGAPORE TECH ENGINEERING LTD	S63:SGX
SINGAPORE WINDSOR HOLDINGS LTD	Y45:SGX
SINGAPURA FINANCE LTD	S23:SGX
SINGHAIYI GROUP LTD.	5H0:CATALIST
SINGTEL	Z74:SGX
SINJIA LAND LIMITED	5HH:SGX
SINO CONSTRUCTION LIMITED	F3V:SGX
SINO GRANDNESS FOOD IND GP LTD	T4B:SGX
SINO TECHFIBRE LIMITED	AD8:SGX
SINOPIPE HOLDINGS LIMITED	X06:SGX
SINOSTAR PEC HOLDINGS LIMITED	C9Q:SGX
SINOTEL TECHNOLOGIES LTD.	D3W:SGX
SINWA LIMITED	5CN:SGX
SITRA HOLDINGS (INTL) LIMITED	5LE:CATALIST
SKY ONE HOLDINGS LIMITED	5MM:CATALIST
SMARTFLEX HOLDINGS LTD	5RE:CATALIST
SMRT CORPORATION LTD	S53:SGX
SOILBUILD BUSINESS SPACE REIT	SV3U:SGX
SOILBUILD CONSTRUCTION GRP LTD	S7P:SGX
SOON LIAN HOLDINGS LIMITED	5MD:CATALIST
SOUP RESTAURANT GROUP LIMITED	5KI:SGX
SOUTHERN PACKAGING GROUP LTD	T77:SGX
SP AUSNET	X04:SGX
SP CORPORATION LIMITED	S13:SGX
SPH REIT	SK6U:SGX
SPINDEX INDUSTRIES LIMITED	564:SGX
SRI TRANG AGRO-INDUSTRY PCL	NC2:SGX
ST. JAMES HOLDINGS LIMITED	5NH:CATALIST
STAMFORD LAND CORPORATION LTD	H07:SGX
STAMFORD TYRES CORPORATIONLTD	S29:SGX
STAR PHARMACEUTICAL LIMITED	X64:SGX
STARHILL GLOBAL REIT	P40U:SGX
STARHUB LTD	CC3:SGX
STARLAND HOLDINGS LIMITED	5UA:CATALIST
STATS CHIPPAC LTD	S24:SGX
STRACO CORPORATION LIMITED	S85:SGX
STRAITS TRADING CO. LTD	S20:SGX
STRATECH SYSTEMS LIMITED	S73:SGX
SUNLIGHT GROUP HLDG LTD	5AI:CATALIST
SUNMART HOLDINGS LIMITED	C2J:SGX
SUNMOON FOOD COMPANY LIMITED	F06:SGX
SUNNINGDALE TECH LTD	T35:SGX
SUNPOWER GROUP LTD.	5GD:SGX
SUNRIGHT LTD	S71:SGX
SUNTAR ECO-CITY LIMITED	CZ3:SGX
SUNTEC REAL ESTATE INV TRUST	T82U:SGX
SUNVIC CHEMICAL HOLDINGS LTD	A7S:SGX
SUPER GROUP LTD.	S10:SGX
SUPERBOWL HOLDINGS LIMITED	S48:SGX
SURFACE MOUNT TECH (HLDGS) LTD	Q7Q:SGX
SWEE HONG LIMITED	QF6:SGX
SWIBER HOLDINGS LIMITED	AK3:SGX
SWING MEDIA TECHNOLOGY GRP LTD	O2F:SGX
SWISSCO HOLDINGS LIMITED	5FD:SGX
SYSMA HOLDINGS LIMITED	5UO:CATALIST
TA CORPORATION LTD	PA3:SGX
TAI SIN ELECTRIC LIMITED	500:SGX
TALKMED GROUP LIMITED	5G3:CATALIST
TAT HONG HOLDINGS LTD	T03:SGX
TAT SENG PACKAGING GROUP LTD	T12:SGX
TECHCOMP (HOLDINGS) LIMITED	T43:SGX
TECHNICS OIL & GAS LIMITED	5CQ:SGX
TECKWAH INDUSTRIAL CORP LTD	561:SGX
TEE INTERNATIONAL LIMITED	M1Z:SGX
TEE LAND LIMITED	S9B:SGX
TEHO INTERNATIONAL INC LTD.	5OQ:CATALIST
TELECHOICE INTERNATIONAL LTD	T41:SGX
TELEDATA (SINGAPORE) LTD	T28:SGX
TEXCHEM-PACK HOLDINGS (S) LTD.	AI1:SGX
THAI BEVERAGE PUBLIC CO LTD	Y92:SGX
THAKRAL CORPORATION LTD	T04:SGX
THE HOUR GLASS LIMITED	E5P:SGX
TIANJIN ZHONG XIN PHARM GROUP	T14:SGX
TIGER AIRWAYS HOLDINGS LIMITED	J7X:SGX
TIH LIMITED	T55:SGX
TIONG SENG HOLDINGS LIMITED	K2P:SGX
TIONG WOON CORP HOLDING LTD	T06:SGX
TMC EDUCATION CORPORATION LTD	586:CATALIST
TOP GLOBAL LIMITED	519:SGX
TOSEI CORPORATION	S2D:SGX
TOTAL ACCESS COMM PUB CO LTD	B2W:SGX
TPV TECHNOLOGY LIMITED	T18:SGX
TRANSCORP HOLDINGS LIMITED	T19:SGX
TRANSCU GROUP LIMITED	E15:SGX
TRANSIT-MIXED CONCRETE LTD	570:SGX
TRAVELITE HOLDINGS LTD.	5KH:SGX
TREK 2000 INT'L LTD	5AB:SGX
TRITECH GROUP LIMITED	5G9:CATALIST
TRIYARDS HOLDINGS LIMITED	RC5:SGX
TSH CORPORATION LIMITED	574:CATALIST
TT INTERNATIONAL LIMITED	T09:SGX
TTJ HOLDINGS LIMITED	K1Q:SGX
TUAN SING HOLDINGS LIMITED	T24:SGX
TUNG LOK RESTAURANTS 2000 LTD	540:CATALIST
TYE SOON LTD	T08:SGX
UE E&C LTD.	NI3:SGX
UMS HOLDINGS LIMITED	558:SGX
UNI-ASIA HOLDINGS LIMITED	C3T:SGX
UNION STEEL HOLDINGS LIMITED	V69:SGX
UNIONMET (SINGAPORE) LIMITED	A6F:SGX
UNITED ENGINEERS LTD ORD	U04:SGX
UNITED ENVIROTECH LTD	U19:SGX
UNITED FIBER SYSTEM LIMITED	P30:SGX
UNITED FOOD HOLDINGS LIMITED	U01:SGX
UNITED INDUSTRIAL CORP LTD	U06:SGX
UNITED OVERSEAS AUSTRALIA LTD	EH5:SGX
UNITED OVERSEAS BANK LTD	U11:SGX
UNITED OVERSEAS INSURANCE LTD	U13:SGX
UNIVERSAL RESOURCE & SVCS LTD	W81:SGX
UOB-KAY HIAN HOLDINGS LIMITED	U10:SGX
UOL GROUP LIMITED	U14:SGX
UPP HOLDINGS LIMITED	U09:SGX
VALLIANZ HOLDINGS LIMITED	545:CATALIST
VALUEMAX GROUP LIMITED	T6I:SGX
VALUETRONICS HOLDINGS LIMITED	BN2:SGX
VARD HOLDINGS LIMITED	MS7:SGX
VASHION GROUP LTD.	5BA:CATALIST
VENTURE CORPORATION LIMITED	V03:SGX
VGO CORPORATION LIMITED	PH0:SGX
VIBRANT GROUP LIMITED	F01:SGX
VIBROPOWER CORPORATION LIMITED	535:SGX
VICOM LTD	V01:SGX
VICPLAS INTERNATIONAL LTD	569:SGX
VIKING OFFSHORE AND MARINE LTD	557:CATALIST
VIVA INDUSTRIAL TRUST	T8B:SGX
W CORPORATION LIMITED	OJ4:SGX
WE HOLDINGS LTD.	5RJ:CATALIST
WEE HUR HOLDINGS LTD.	E3B:SGX
WEIYE HOLDINGS LIMITED	ON7:SGX
WHEELOCK PROPERTIES (S) LTD	M35:SGX
WILLAS-ARRAY ELEC (HLDGS) LTD	W12:SGX
WILMAR INTERNATIONAL LIMITED	F34:SGX
WILTON RESOURCES CORP LIMITED	5F7:CATALIST
WING TAI HLDGS LTD	W05:SGX
WORLD PRECISION MACHINERY LTD	B49:SGX
XINREN ALUMINUM HOLDINGS LTD	MN5:SGX
XMH HOLDINGS LTD.	M9F:SGX
XPRESS HOLDINGS LTD	I04:SGX
"XYEC HOLDINGS CO., LTD."	5WR:CATALIST
YAMADA GREEN RESOURCES LIMITED	MC7:SGX
YANGZIJIANG SHIPBLDG HLDGS LTD	BS6:SGX
YANLORD LAND GROUP LIMITED	Z25:SGX
YEO HIAP SENG LTD	Y03:SGX
YHI INTERNATIONAL LIMITED	Y08:SGX
YING LI INTL REAL ESTATE LTD	5DM:SGX
YOMA STRATEGIC HOLDINGS LTD	Z59:SGX
YONG XIN INTL HOLDINGS LTD.	CX5:SGX
YONGMAO HOLDINGS LIMITED	E6A:SGX
YONGNAM HOLDINGS LIMITED	Y02:SGX
YOUYUE INTERNATIONAL LIMITED	Y06:SGX
YUEXIU PROPERTY CO LIMITED	G10:SGX
ZAGRO ASIA LIMITED	Z01:SGX
ZHONGMIN BAIHUI RETAIL GRP LTD	5SR:SGX
ZHONGXIN FRUIT AND JUICE LTD	5EG:CATALIST
ZIWO HOLDINGS LTD.	I9T:SGX
Z-OBEE HOLDINGS LIMITED	D5N:SGX